R 1600 900
NO ./0.xpm
SO ./1.xpm
WE ./2.xpm
EA ./3.xpm
S ./0.xpm
F 254,161,77
C 10,151,176
11111111111111111111
10000000000000000001
10000000000000000001
10000000000000000001
10000000000000000001
11111111111111111111