R 1600 900
NO ./xpm/0.xpm
SO ./xpm/1.xpm
WE ./xpm/2.xpm
EA ./xpm/3.xpm
S ./xpm/0.xpm
F 254,161,77
C 10,151,176
11111111111111111111
10000000000000000001
10000000000000000001
100000000N0000000001
10000000000000000001
11111111111111111111